******
*!   *
* ## *
*  EE*
******