*****
*E  **
*!## *
**   *
 **  *
  **E*
   ***