******
*EEE *
*  # *
* *#**
*  # *
*  ! *
******