 *********
 *    *  *
** #*#*  *
*  E#E!  *
*  E*    *
**********