****** *****
*    ***   *
* ##     *!*
* # *EEE   *
*   ********
*****      *